1111111111111111111111111
1                       1
1                       1
1                       1
1                       1
1 1  1 111 1 1          1
1 1 1  1   1 1          1
1 11   111  1           1
1 1 1  1    1           1
1 1  1 111  1           1
1                       1
1                       1
1                  d    1
1                       1
1                       1
1111111111111111111111111

p 3,3
k 20,3
