11111 11111 11111 11111 11111
10000 00000 00000 00000 00001
10p00 00000 00000 0000k 00001
10000 00000 00000 00000 00001

10000 00000 00000 00000 00001
10000 00000 00000 00000 00001
10000 00000 00000 00000 00001
10000 00000 00000 00000 00001

10000 00000 00000 00000 00001
10000 00000 00000 00000 00001
10000 00000 00000 00000 00001
10000 00000 00000 00000 00001

10000 00000 00000 00002 00001
10000 00000 00000 00000 00001
10000 00000 00000 00000 00001
11111 11111 11111 11111 11111
