1111111111111111111111111
1000000000000000000000001
10p0000000000000000k00001
100^>>>000000000000000001
100^00v000000000000000001
100^00v000000000000000001
100<<<v000000000000000001
1000000000000000000000001
1000000000000000000000001
1000000000000000000000001
1000000000000000000000001
1000000000000000000000001
1000000000000000000200001
1000000000000000000000001
1000000000000000000000001
1111111111111111111111111
