0000000000000000000000000
0000000000000000000000000
0000000000000000000000000
0000000000000000000000000
0000000000000000000000000
0000000000011100001110000
000000000011t210011011000
00000000011u0u10010001000
000000000011t110010001000
000000000001w100010001000
0000000000010100010001000
0000000000010100010001000
0000000000010100010001000
000000000001w100010001000
0000000000110110011011000
0000000000111110001110000

p 13,15
k 13,8
