                         
                         
                         
                         
                         
           111    111    
          11td1  11 11   
         11u u1  1   1   
          11t11  1   1   
           1w1   1   1   
           1 1   1   1   
           1 1   1   1   
           1 1   1   1   
           1w1   1   1   
          11 11  11 11   
          11111   111    

p 13,15
k 13,8
