1111111111111111111111111
1                       1
1                w    u 1
1                       1
1                       1
1          1111         1
1          1tw1         1
1          1111         1
1                       1
1 du                  t 1
1                       1
1                       1
1                       1
1                       1
1                       1
1111111111111111111111111

; Designed by Alex G.
p 2,10 
k 24,10
