1111111111111111111111111
1000000000000000000000001
10000000000000000w0000u01
1000000000000000000000001
1000000000000000000000001
1000000000011110000000001
100000000001tw10000000001
1000000000011110000000001
1000000000000000000000001
102u000000000000000000t01
1000000000000000000000001
1000000000000000000000001
1000000000000000000000001
1000000000000000000000001
1000000000000000000000001
1111111111111111111111111

; Designed by Alex G.
p 2,10 
k 24,10
