11111 11111 11111 11111 11111
10000 00000 00000 00000 00001
10000 00000 00000 00v00 00u01
10000 00000 00000 00000 00001

10000 00000 00000 00000 00001
10000 00000 01111 00000 00001
10000 00000 01tv1 00000 00001
10000 00000 01111 00000 00001

10000 00000 00000 00000 00001
1p2u0 00000 00000 00000 00tk1
10000 00000 00000 00000 00001
10000 00000 00000 00000 00001

10000 00000 00000 00000 00001
10000 00000 00000 00000 00001
10000 00000 00000 00000 00001
11111 11111 11111 11111 11111


Designed by Alex G.
