11111 11111 11111 11111 11111
1wwww wwwww wwwww wwwww wwww1
1w000 00000 00000 00000 00pw1
1w000 00000 00000 000u0 000w1

1w000 00000 00000 00000 000w1
1w000 00000 00000 00000 000w1
1w000 00000 00uk0 00000 000w1
1w000 00000 00000 00000 000w1

1w000 00000 00000 00000 000w1
1w000 00000 00000 00000 000w1
1w000 0w000 00t00 00000 000w1
1w000 00000 00000 00000 000w1

1w000 00000 00000 00000 000w1
1w000 00000 00000 00000 000w1
1wwww wwwww wwwww wwwww wwww1
11111 11111 11111 11111 111t2

Designed by Alex G.
