11111 11111 11111 11111 11111
1vvvv vvvvv vvvvv vvvvv vvvv1
1v000 00000 00000 00000 00pv1
1v000 00000 00000 000u0 000v1

1v000 00000 00000 00000 000v1
1v000 00000 00000 00000 000v1
1v000 00000 00uk0 00000 000v1
1v000 00000 00000 00000 000v1

1v000 00000 00000 00000 000v1
1v000 00000 00000 00000 000v1
1v000 0v000 00t00 00000 000v1
1v000 00000 00000 00000 000v1

1v000 00000 00000 00000 000v1
1v000 00000 00000 00000 000v1
1vvvv vvvvv vvvvv vvvvv vvvv1
11111 11111 11111 11111 111t2

Designed by Alex G.
