1111111111111111111111111
1wwwwwwwwwwwwwwwwwwwwwww1
1w000000000000000000000w1
1w0000000000000000u0000w1
1w000000000000000000000w1
1w000000000000000000000w1
1w0000000000u0000000000w1
1w000000000000000000000w1
1w000000000000000000000w1
1w000000000000000000000w1
1w0000w00000t0000000000w1
1w000000000000000000000w1
1w000000000000000000000w1
1w000000000000000000000w1
1wwwwwwwwwwwwwwwwwwwwwww1
11111111111111111111111t2

; Designed by Alex G.

p 23,3
k 14,7
