11111 11111 11111 11111 11111
10000 00000 0tku0 00000 00001
10000 00000 00w00 00000 00001
10000 00000 00000 00000 00001

10000 00000 00000 00000 00001
10000 00000 00000 00000 00001
10000 00000 00000 00000 00001
10000 00000 00000 00000 00001

10000 00000 00000 00000 00001
1w000 00000 00000 00000 00001
12u00 00000 00000 00000 00001
1t000 00000 00000 00000 00001

10000 00000 00w00 00000 00001
10000 00000 0tpu0 00000 00001
10000 00000 00000 00000 00001 
11111 11111 11111 11111 11111

Designed by Alex G.
