1111111111111111111111111
1          t u          1
1           w           1
1                       1
1                       1
1                       1
1                       1
1                       1
1                       1
1w                      1
1du                     1
1t                      1
1           w           1
1          t u          1
1                       1
1111111111111111111111111

; Designed by Alex G.
p 13,14
k 13,2
