1111111111111111111111111
10000000000t0u00000000001
100000000000w000000000001
1000000000000000000000001
1000000000000000000000001
1000000000000000000000001
1000000000000000000000001
1000000000000000000000001
1000000000000000000000001
1w00000000000000000000001
12u0000000000000000000001
1t00000000000000000000001
100000000000w000000000001
10000000000t0u00000000001
1000000000000000000000001
1111111111111111111111111

; Designed by Alex G.
p 13,14
k 13,2
