0000000000000000000000000
0000000000000000000000000
000000000uuuuuuu000000000
000000000u00000u000000000
00000000uu000uu0000000000
0000000uu00uu000000000000
000000uu00uu0000000000000
00000uu00wu00000000000000
00000uuuuuu00000000000000
00000000000000tttttt00000
00000000000000w0002t00000
00000000000000t0000t00000
00000000000000t0000t00000
00000000000000t0000t00000
00000000000000tttttt00000
0000000000000000000000000

; Designed by Alex G.

p 19,14
k 15,4
