0000000000001000000000000
0111111111111111111111110
0111111111111111111111110
0111111111111111111111110
0111111111111111111111110
0111111111111111111111110
011111111111111111111111w
0111111111111111111111110
0111111111112w11111111110
0111111111111111111111110
0111111111111111111111110
0111111111111111111111110
0111111111111111111111110
0111111111111111111111110
0111111111111111111111110
0000000000001000000000000

p 1,2
k 25,6
