            1            
 11111111111111111111111 
 11111111111111111111111 
 11111111111111111111111 
 11111111111111111111111 
 11111111111111111111111 
 11111111111111111111111w
 11111111111111111111111 
 11111111111dw1111111111 
 11111111111111111111111 
 11111111111111111111111 
 11111111111111111111111 
 11111111111111111111111 
 11111111111111111111111 
 11111111111111111111111 
            1            

p 1,2
k 25,6
