0000000000000000000000000
1111111111110000000000000
1>>>>>>>>>v10000000000000
1111111111v10000000000000
0000000001v10000000000000
0000000001v10000000000000
0000000001v10000000000000
0000000001v10000000000000
0000000001v10000000000000
0000000001v10000000000000
0000000001v10000000000000
0000000001210000000000000
0000000001110000000000000
0000000000000000000000000
0000000000000000000000000 
0000000000000000000000000

p 2,3
k 11,8
