>>>>>>>>>>>>v<<<<<<<<<<<<
>>>>>>>>>>>>v<<<<<<<<<<<<
>>>>>>>>>>>>v<<<<<<<<<<<<
>>>>>>>>>>>>v<<<<<<<<<<<<
111111111111v111111111111
210000000001v10000000001t
010000000001v1000000001u0
010000000001v100000001w00
010000000001v100000001000
110000000001v100000001111
000000000001v100000000000
000000000001v100000000000
000000000001v100000000000
00000000000tv100000000000
00000000000uv100000000000 
00000000000wv100000000000


p 1,1
k 13,  11
