>>11111111111111111111111
>v111111111<<<<<<<<<<<<^1
1v>>1111111v11111111111^1
1v>v1111111v11111111111^1
111v1111111v11111111111^1
111 >>>>v11v>>>>>>>>>>>>1
111<1111v1111111111111111
<<<<<<1<v11111111<<<<<<<<
1111111v111111111v1111111
1111111v111111111v1111111
111<<<< 111111111v1111111
111v  1>>>>>>>111v1111111
111v  11111111111v1111111
   v  11111111111v1111111
 11>>>>>>>>>>>>>>>>>>>>v1
 1111111111111111111111 d

p 1,1
k 24,16
