>>11111111111111111111111
>v111111111<<<<<<<<<<<<^1
1v>>1111111v11111111111^1
1v>v1111111v11111111111^1
111v1111111v11111111111^1
1110>>>>v11v>>>>>>>>>>>>1
111<1111v1111111111111111
<<<<<<1<v11111111<<<<<<<<
1111111v111111111v1111111
1111111v111111111v1111111
111<<<<0111111111v1111111
111v001>>>>>>>111v1111111
111v0011111111111v1111111
000v0011111111111v1111111
011>>>>>>>>>>>>>>>>>>>>v1 
0111111111111111111111102

p 1,1
k 24,16
