1111111111111111111111111
1000100000000000000000001
1000100000000000000000001
1000100000000000000000001
1000100000000000000000001
1000100000000000000000001
1000120000000000000000001
1000111111111110000000001
1000000000000000000000001
1000000000000000000000001
1000000000000000000000001
1000000000000000000000001
1000000000000000000000001
1000000000000000000000001
1000000000000000000000001
1111111111111111111111111

p 2,2
k 7,7
