1111111111111111111111111
1   1                   1
1   1                   1
1   1                   1
1   1                   1
1   1                   1
1   1d                  1
1   11111111111         1
1                       1
1 111  1 1 1   1 1      1
1 1 1  1 1 11  1 1      1
1 111  1 1 1 1 1 1      1
1 1 1  1 1 1  11        1
1 1  1 111 1   1 1      1
1                       1
1111111111111111111111111

p 2,2
k 7,7
