11111 11111 11111 11111 11111
1p001 00000 00000 00000 00001
10001 00000 00000 00000 00001
10001 00000 00000 00000 00001

10001 00000 00000 00000 00001
10001 00000 00000 00000 00001
10001 2k000 00000 00000 00001
10001 11111 11111 00000 00001

10000 00000 00000 00000 00001
10000 00000 00000 00000 00001
10000 00000 00000 00000 00001
10000 00000 00000 00000 00001

10000 00000 00000 00000 00001
10000 00000 00000 00000 00001
10000 00000 00000 00000 00001
11111 11111 11111 11111 11111
