1111111111111111111111111
1^>>>>>>>>>>>>>>>>>>>>111
111111111111111111111v111
111^>>>>>>>>>>>>>>>>1v111
111^111111111111111v1v111
111^1^>>>>>>>>>>>>1v1v111
111^1^11111111111v1v1v111
111^1^1^>>>>>>>21v1v1v111
111^1^1^111111111v1v1v111
111^1^1^<<<<<<<<<v1v1v111
111^1^1111111111111v1v111
111^1<<<<<<<<<<<<<<v1v111
111^11111111111111111v111
111<<<<<<<<<<<<<<<<<<v111
1111111111111111111111111
1111111111111111111111111

p 2,2
k 3,2
