^v>>>>>>>>>>>>>>>>>>>>>>1
^v111111111111111111111v1
^v<<<<<<<<<<<<<<<<<<<<<<1
^v111111111111^1111111111
^v111111111111^1111111111
^v111111111111^1111111111
^v111111111111^1111111111
^v>>>>>>>>>>>>>1111111111
^v111111111    1111111111
^v111111111    1111111111
^v111111111    1111111111
^v111111111    1111111111
^v111111111    1111111111
^v111111111   d1111111111
^v11111111111111111111111
^v11111111111111111111111

p 1,1
k 24,2 
