                         
 11111111111111111111111 
 1>>>>>>>>>>>>>>>>>>>vw1 
 1^>^^^^^^^^^^^^^^<<<v^1 
 1^^>^>^>>^>^^<<<<^^^v^1 
 1^ ^>^^^>^^^^^^^^^^^v^1 
 1^ ^^>^^>^>^>^^<<^>^v^1 
 1^ ^^v>^vv^>^^^^>^^vv^1 
 1^ ^^^^>^^<<<<^>^^^^v^1 
 1^ ^^^^^^>^^^^>^^^>^v^1 
 1^ ^^^>^>^^>^^^>^^<<v^1 
 1^ ^>^>^^^>^^^^^>^vvv^1 
 1^ ^^>^^^>^>^>^^^^^^^^1 
w1t d^^^>>^>>^>^^^>^>^^1t
 11111111111111111111111 
u                       u

p 1,15
k 4,6
