 1111111111111111111111 1
 1111111111111111111111 1
 1111111111111111111111 1
                         
 11 111111111 111111111 1
 11 1^>>>>>>1 1^>>>>>>1 1
 11 1^d111wv1 1^t111wv1 1
 11 1<<<<<<v1 1<<<<<<v1 1
 11 1111^1111 111111111 1
       1^1               
 11111 1^1  11111111111 1
 11111 1^1  11111111111 1
 11111 1^1  11111111111 1
 11111 1t1  11111111111 1
 11111 111  11111111111 1
                         

p 6,7
k 17,7
