^                     111
^1                    1>>
1111111111            1^1
1111111111            1^1
<<w111u>v1            1^1
v11w1u11v1    1v1     1^1
v<t1t111v1    1v1     1^1
v1111111v1    1v1     1^1
v1111111v1    1v1     1^1
v<<<<<<<v1    1v1     1^1
v111111111  111v111   1^1
v1           11d11    1^<
11            111     111
11             1         
11                       
11                       

p 5,6
k 1,1
