1 1 1 1 1 1 1 1 1 1 1 1 1
 v<<<<<^ ^>>>>> 1<<<<<<^1
1v     ^1^    v 1 1 1 1^1
 v  d  ^ ^    v  ^>>>> ^1
1v     ^1^    v 1^1 1v1^1
 v>>>>>> <<<<<v >>1 1v>>1
1 1 1 1 1 1 1 1 1 1 1 1 1
>>>>>>>>>>>>>>>>>>>>>>>>>
                        1
  11 11 11 11 11 11 11 11
  11 11 11 11 11 11 11 11
                        1
 1vv111111111111111111111
 1>v11>>>>>v111>>>>v111> 
111v>>>^111>>>>^111>>>>^1
1111111111111111111111111

p 1,2
k 23,15
