1111111111111111111111111
1                       1
1                       1
1                       1
1                       1
1                       1
1                       1
1                       1
1    11 11     11 11    1
1    1   1     1   1    1
1    1d  1     1   1    1
1    11111     11111    1
1                       1
1                       1
1                       1
1111111111111111111111111

p 24,2
k 17,10
