11111 11111 11111 11111 11111
10000 00000 00000 00000 000p1
10000 00000 00000 00000 00001
10000 00000 00000 00000 00001

10000 00000 00000 00000 00001
10000 00000 00000 00000 00001
10000 00000 00000 00000 00001
10000 00000 00000 00000 00001

10000 11011 00000 11011 00001
10000 10001 00000 1k001 00001
10000 12001 00000 10001 00001
10000 11111 00000 11111 00001

10000 00000 00000 00000 00001
10000 00000 00000 00000 00001
10000 00000 00000 00000 00001
11111 11111 11111 11111 11111
