1111111111111111111111111
1000000000000000000000001
1000000000000000000000001
1000000000000000000000001
1000000000000000000000001
1000000000000000000000001
1000000000000000000000001
1000000000000000000000001
1000011011000001101100001
1000010001000001000100001
1000012001000001000100001
1000011111000001111100001
1000000000000000000000001
1000000000000000000000001
1000000000000000000000001
1111111111111111111111111

p 24,2
k 17,10
