1v<<<<<<<<<1  11111v^v^v1
1v11111111^1 111111v>v^<1
1>>>>>>>>>^1>>>>>u1v^v^v1
1 11111111111111111v>v^<1
1 1u       w1w     v^v^v1
1 11111111111111111v>v^<1
1 1      1dt1     1v^v^v1
1 111111 111111   1v>v^<1
1 1t          111 1v^v^v1
1 111111111     1 1v>v^<1
1         1111  1 1v^v^v1
1 111 1 1 1     1 1v>v^<1
1 1 1 1 1 1111  1 1v^v^v1
1 1 1 1 1    1  1 1v>v^<1
1 1 1 1 1 11 1          1
111 111 1    1  111111111

p 9,3
k 4,13
