1111111111111111111111111
1000000000000000000000001
1011111111000000000000001
1011111111000000000000001
1011121111000000000000001
1011101111000000000000001
1011101111000000000000001
1011101111000000000000001
1000000000000000000000001
1000000000000000000000001
1000000000000000000000001
1000000000000000000000001
1000000000000000000000001
1000000000000000000000001
1000000000000000000000001
1111111111111111111111111

p 2,15
k 24,2
