1111111111111111111111111
1                       1
1 11111111              1
1 11111111              1
1 111d1111              1
1 111 1111              1
1 111 1111              1
1 111 1111              1
1                       1
1                       1
1                       1
1                       1
1                       1
1                       1
1                       1
1111111111111111111111111

p 2,15
k 24,2
