11111 11111 11111 11111 11111
10000 00000 00000 00000 000k1
10111 11111 00000 00000 00001
10111 11111 00000 00000 00001

10111 21111 00000 00000 00001
10111 01111 00000 00000 00001
10111 01111 00000 00000 00001
10111 01111 00000 00000 00001

10000 00000 00000 00000 00001
10000 00000 00000 00000 00001
10000 00000 00000 00000 00001
10000 00000 00000 00000 00001

10000 00000 00000 00000 00001
10000 00000 00000 00000 00001
1p000 00000 00000 00000 00001
11111 11111 11111 11111 11111
