11111 11111 11111 11111 11111
1p000 00000 00000 00000 00001
11111 11111 11111 11111 11101
11111 11111 11111 11111 11101

10000 00000 00001 1211k 11101
10000 00000 00001 10110 11101
10000 00000 00001 10110 11101
10000 00000 00000 00000 11101

10000 00000 00000 00000 11101
10000 00000 00000 00000 11101
10000 00000 00000 00000 11101
10000 00000 00000 00000 11101

10000 00000 00000 00000 11101
10000 00000 00000 00000 11101
10000 00000 00000 00000 00001
11111 11111 11111 11111 11111
