1111111111111111111111111
1000000000000000000000001
1111111111111111111111101
1111111111111111111111101
1000000000000011211011101
1000000000000011011011101
1000000000000011011011101
1000000000000000000011101
1000000000000000000011101
1000000000000000000011101
1000000000000000000011101
1000000000000000000011101
1000000000000000000011101
1000000000000000000011101
1000000000000000000000001
1111111111111111111111111

k 20,5
p 2,2
