1111111111111111111111111
1                       1
11111111111111111111111 1
11111111111111111111111 1
1             11d11 111 1
1             11 11 111 1
1             11 11 111 1
1                   111 1
1                   111 1
1                   111 1
1                   111 1
1                   111 1
1                   111 1
1                   111 1
1                       1
1111111111111111111111111

k 20,5
p 2,2
