1111111111111111111111111
1000000000000000000000001
1000000000000000000000001
1000000000000000000000001
1000000000000000000000001
1000000000000000t00000001
1000000011111111111100001
1000000010000000t00100001
1000000010000000000100001
1000000010000000000100001
1000000010200000000100001
1000000010000000000100001
1000000011111111111100001
1000000000000000000000001
1000000000000000000000001
1111111111111111111111111

p  8,11
k 10,11
