1111111111111111111111111
1                       1
1                       1
1                       1
1                       1
1               t       1
1       111111111111    1
1       1       t  1    1
1       1          1    1
1       1          1    1
1       1 d        1    1
1       1          1    1
1       111111111111    1
1                       1
1                       1
1111111111111111111111111

p  8,11
k 10,11
