11111 11111 11111 11111 11111
10000 00000 00000 00000 00001
10000 00000 00000 00000 00001
10000 00000 00000 00000 00001

10000 00000 00000 00000 00001
10000 00000 00000 0t000 00001
10000 00011 11111 11111 00001
10000 00010 00000 0t001 00001

10000 00010 00000 00001 00001
10000 00010 00000 00001 00001
10000 00p1k 20000 00001 00001
10000 00010 00000 00001 00001

10000 00011 11111 11111 00001
10000 00000 00000 00000 00001
10000 00000 00000 00000 00001
11111 11111 11111 11111 11111
