11111 11111 11111 11111 11111
1p000 00000 00000 00000 000t1
11111 11111 11111 11111 11111
10000 00000 00000 00000 00001

10000 00000 00000 00000 00001
10000 00000 00000 00000 00001
10000 00000 00t00 00000 00001
10000 00000 00k00 00000 00001

10000 00000 00u00 00000 00001
10000 00000 00000 00000 00001
10000 00000 00000 00000 00001
10000 00000 00000 00000 00001

10000 00000 00000 00000 00001
11111 11111 11111 11111 11111
1u000 00000 00000 00000 00021
11111 11111 11111 11111 11111
