1111111111111111111111111
10000000000000000000000t1
1111111111111111111111111
1000000000000000000000001
1000000000000000000000001
1000000000000000000000001
100000000000t000000000001
1000000000000000000000001
100000000000u000000000001
1000000000000000000000001
1000000000000000000000001
1000000000000000000000001
1000000000000000000000001
1111111111111111111111111
1u00000000000000000000021
1111111111111111111111111

p  2,2
k 13,8
