1111111111111111111111111
1                      t1
1111111111111111111111111
1                       1
1                       1
1                       1
1           t           1
1                       1
1           u           1
1                       1
1                       1
1                       1
1                       1
1111111111111111111111111
1u                     d1
1111111111111111111111111

p  2,2
k 13,8
