1111111111111111111111111
1d t1     11111     1t  1
1   1     11111     1  w1
11111     11111     11111
1         11111         1
1         11111         1
11111111111   11111111111
11111111111   11111111111
11111111111   11111111111
1         11111         1
1         11111         1
1         11111         1
11111     11111     11111
1w  1     11111     1   1
1  u1     11111     1u  1
1111111111111111111111111

p 24,15
k 24,2
