11111 11111 11111 11111 11111
120t1 00000 11111 00000 1t0k1
10001 00000 11111 00000 100w1
11111 00000 11111 00000 11111

10000 00000 11111 00000 00001
10000 00000 11111 00000 00001
11111 11111 10001 11111 11111
11111 11111 10001 11111 11111

11111 11111 10001 11111 11111
10000 00000 11111 00000 00001
10000 00000 11111 00000 00001
10000 00000 11111 00000 00001

11111 00000 11111 00000 11111
1w001 00000 11111 00000 10001
100u1 00000 11111 00000 1u0p1
11111 11111 11111 11111 11111
