1111111111111111111111111
120t10000011111000001t001
10001000001111100000100w1
1111100000111110000011111
1000000000111110000000001
1000000000111110000000001
1111111111100011111111111
1111111111100011111111111
1111111111100011111111111
1000000000111110000000001
1000000000111110000000001
1000000000111110000000001
1111100000111110000011111
1w00100000111110000010001
100u10000011111000001u001
1111111111111111111111111

p 24,15
k 24,2
