0000000000000000000000000
0000000000000000000000000
0000000000000000000000000
0000000000000000000000000
0000011111110111111111110
000001000u0101u0000000w10
0000011111110111111111110
0000000000000000000000000
0000011111000001111100000
00000100t1000001wt2100000
0000011111000001111100000
0000000000000000000000000
0000000000000000000000000
0000000000000000000000000
0000000000000000000000000
0000000000000000000000000

p 7,6 
k 11,6
